going rogue -- идти против правил, не соблюдать правила

inspire -- вдохновлять

curiosity -- любопытство

expand -- расширять 

untill the cows come home -- ждать очень долго

dip your toes in the water -- пробовать, потихоньку, спокойно

purse -- сумочка

afford -- позволить себе 

reliant -- уверенный

colomn -- двоеточие

behavior -- поведение

clauses -- статьи, предложения

quotation -- цитата

moreover -- более того

however -- однако

gut feeling -- внутреннее чутье

foolproof -- надежный

light-hearted response -- беззаботный ответ

good-natured -- добродушный

rivalry -- соперничество

maternity leave -- декретный отпуск

generally -- обычно

obiously -- очевидно

propose -- предлагать

intended -- предназначенный

amusing -- забавный

tough -- жесткий, крепкий

approach -- подход, метод

kitted -- укомплектованный

wrap -- заворачивать

effort -- усилия

loads -- большое количество

action -- действие

consequences -- последствия

conquer -- завоевывать, побеждать

convince -- убеждать

approptiate -- подходящий

invaluable -- бесценный

thorough -- тщательный

stand out -- выделяться

slouch -- сутулость

steer clear -- избегать

genuine -- подлинный

fiddle -- теребить

tweaking -- настройка

revision -- пересмотр

assumptoins -- предположения

subtle -- тонкий

exclamation mark -- восклицательный знак
ellipsis -- троеточие
suppose -- предполагать
